0000000000
0000000100
0000000000
0000000100
0000010000
0000010000
0000000100
0000000000
0000000000
0000000000
