0000000000
0000000000
0000000000
0000000000
0000000000
0000000001
0000000011
0000000111
0000001111
0000011111
