00000000000000111110
00000000000000111110
000l0000000000111110
000l0000000000110110
000l0000000000000000
0001d110000010000000
00000000000000011000
00000000000000011000
00000000000000000000
00110000000000000000
00110000000000000000
00000000000000000000
00000000000000000000
00000000000000001100
00000000000000001100
00000000000000000000
00000000000000000000
00000000000000000000
00000000000000000000
00000000000000000000
